carfax=informazioni sul veicolo
map=mappa
search=cerca
search2=prova a cercare su
uses=usa il nostro
syntax=sintassi
more=altro su
more2=altro
top=top
official=sito ufficiale
password=password casuale
number=numero casuale
random=a caso
entry=voce nel
web=link web
web2=prova i link web
mean=può significare diverse cose
meant=clicca ciò che intendevi con
meanings=significati
meanings2=alcuni significati
dictionary=dizionario
package=localizzazione del pacco
ip-go=prova ad andare lì
parked-domain=è un dominio registrato (l'ultima volta che abbiamo controllato).
area-code=è un prefisso telefonico di
zip-code=è un codice postale di
phone-number=è un numero telefonico di
reverse-search=ricerca inversa
pay=paga
free=free
results=usa risultati da
results2=risultati da
topic=argomento errato?
topics=alcuni argomenti raggruppati in
topics2=più argomenti
topics3=argomenti
sections=raggruppati in sezioni
and=e
links=più links
related=argomenti correlati
related2=più argomenti correlati
at=a
ignore=ignora questa casella prego
put=inserisci i termini di ricerca qui
settings=configurazione
goodies=chicche
spread=diffondi
add=aggiungi a
region=da qualsiasi regione
ducky=mi sento ducky
sort=ordina per data
popular=popolare
programming=programmazione
images=immagini
news=notizie
zero=informazioni zero-click
requires=questa pagina richiede
version=ottieni la versione non-JS
here=qui
category=categoria
