carfax=voertuig informatie
map=map
search=zoeken
search2=probeer zoeken op
uses=gebruik ons
syntax=syntaxis
more=meer bij
more2=meer
top=boven
official=officiele webpagina
password=willekeurig wachtwoord
number=willekeurig getal
random=willekeurig
entry=ingang binnen
web=web links
web2=probeer web links
mean=kan verschillende dingen betekenen
meant=klik wat u bedoelde met
meanings=betekenissen
meanings2=sommige betekenissen
dictionary=woordenboek
package=verzending volgen
ip-go=probeer daar te gaan
parked-domain=is een geparkeerd domein (laatste keer dat wij controleerde).
area-code=is een landnummer in
zip-code=is een postcode in
phone-number=is een telefoonnummer in
reverse-search=omgekeerd zoekopdracht
pay=betaal
free=vrij
results=gebruik resultaten van
results2=resultaten van
topic=geen juist onderwerp?
topics=sommige onderwerpen gegroepeerd in
topics2=meer onderwerpen
topics3=onderwerpen
sections=gegroepeerd in secties 
and=en
links=meer links
related=gerelateerde onderwerpen
related2=meer gerelateerde onderwerpen
at=bij
ignore=negeer deze box alstublieft
put=zet zoekopdracht term hier
settings=instellingen
goodies=goodies
spread=verspreid
add=voeg toe aan
region=van elk gebied
ducky=I'm feeling ducky
sort=sorteer op datum
popular=populair
programming=programmering
images=afbeeldingen
news=nieuws
zero=zero-click informatie
requires=deze pagina vereist
version=krijg de niet-JS versie
here=hier
category=categorie
